---
####..#
#.....#
#P###.#
#..##+#
#######
